aaron			duncan, yueh, nefud
adam			e, nefud, bashar, burseg (DONE)
adam medina		fenring, feyd, other e, jamis, bewt, nefud
andrew ruth		caid
ben				piter (done), nefud, kudu, sook
billy cain
brian briskey	stilgar, kynes
brook			nefud or kudu, piter
bruce		aramsham, gurney
byron
carver		burseg, master bewt (DONE), sook, yuey
charles		burseg
chuck
cletus		otheym, thufir,
craig		guild, yueh
curtis		nefud, kudu, piter, e
dane		nefud, feyd, e
daniel		jamis, otheym, g, yueh
david
david blackwell
david stahlke
devin			feyd, piter
don 		thufir, yueh
don daro	kudu, nefud, e
dusty		paul
ed			thufir
ed bailey
ed hattaway
eric cepeda		otheym, paul, f
eric doggett	yueh, g
Eric Leikam
francois		e
gabe			duncan, paul, h, e
garret			yueh
gray			h
greg			e
hilary		gurney, duncan, g
jackson		duncan, paul
james			thufir, gurney,  yueh
james koehn		g
jayson			e
jd				otheym, jamis, paul
jeff runnels	aramsham, piter, e
jerome			yueh, g, e (DONE)
jim walters		stilgar, otheym, duncan
jimmy			g
joe lummus		thufir, kynes, gurney, piter
joel			feyd, paul
joey			fenring, yueh, g
john harrison	paul, gurney, duncan, jamis
john mclean
jon ray			paul
joey			fenring, piter, ??
josh			jamis
jp navarro		g, paul
keith			feyd, duncan, paul, piter, e
lupe
marc 			g
marco
matthew		beast (DONE)
me
Michael Morlan		thufir, gurney
michael schmid		baron
mike mann
mike nielson
nick
nils			gurney, piter
paul galvan		paul, duncan, jamis, otheym
philpott		g
pj				piter
prem			emperor
quinn			thufir, gurney, piter
rich 			gurney (DONE)
richard jones	duncan, gurney, e, otheym, jamis
richard ricks
rommel			fenring, e
rory			piter, g
scott bate		gurney, yueh
scott crow		thufir
shark			e-bashar
steph			guild (at least the two tueks), thufir
steve powers		gurney, piter
tony
trenton			pitery, e (DONE)
wade			yueh, kudu, e-caid
walter 			otheym
whymark			piter (DONE)